0000000000000000000000000000000000000000
0331111111111113300000000000000000000000
0331111111111113300000000000000000000000
0220000000000002200000000000000000000000
0220000000000003311111113111111300000000
0220000000000002200000002000000200000000
0220000000000002200000002000000200000000
0220000000000003311111113111113311111330
0331111133000003311111113111113311111330
0000000022000000000000002000002000000220
0000000022000000000000002000002000000220
0000000033111111331111133000003111111330
0000000000000000220000022000002000000220
0000000000000000220000022000002000000220
0000000000000000220000033111113111111330
0000000000000000220000000000000000000000
0331111111111331333311111111111111111330
0331111111111331333311111111111111111330
0220000000000220002200000000000000000220
0220000000000220002200000000000000000220
0220000000000220002200000111331111000220
0220000000000331333300000111331111000220
0220000000000331333300000000220000000220
0220000000000000220000000000220000000220
0331133000000000220000000000220000000220
0331133000000000331333111111331111111330
0000022000000000000222000000000000000000
0000022000000000000222000000000000000000
0000022000000000000222000000000000000000
0000022000000000000222000000000000000000
0000022000000000003333300000000000000000
0000022000000000033333330000000000000000
0000022000000000033333330000000000000000
0000022000000000003333300000000000000000
0000022000000000000222000000000000000000
0000022000000000000222000000000000000000
0000022000000000000222000000000000000000
0111133111111111111333111111111111111100
0111133111111111111333111111111111111100
0000000000000000000000000000000000000000
